111111111111111111
100000000000000001
1000C0000000000001
10000000000E000001
1000000000000P0001
111111111111111111