111111111111111111
10000C000000000001
100000000000000001
100000000000000001
100000000000000001
111111111111111111