111111111111111111
1000000C0000000001
100000000000000001
10000P00000E000001
1000000000000P0001
111111111111111111