1111111111111111111111111111111111
1E00000000X0000C00000C0000000000X1
1010110100100000101001000000010101
1010010010101010001001000000010101
10000000000000000001100000000000C1
1100001100X0000011100000011C0000C1
1001100C110000000C01000000000000C1
1P00000000000000C000000000000XC0C1
1111111111111111111111111111111111