111111111111111111
100000000000000001
1000C0000000000001
10000000000E000P01
100000000000000001
111111111111111111