1111111111111111111111111111111111
1E00000000X0000C00000C000000000001
1110010100100000101001000000010101
1110010010101010001001000000010101
11000000000000000000000000000000C1
1100001100X0000011100000011C0000C1
111P000C110000000C01000000000000C1
1111100000000000C0000000000000C0C1
1111111111111111111111111111111111